  #####
###   #
#   @ #
###$  #
#  .  #
#  ####
####